εργασι -> εργασία : ["Μεταπτυχιακές Εργασίες", "Πτυχιακή εργασία", "Πτυχιακή Εργασία (EL)", "Μεταπτυχιακή διπλωματική εργασία", "Διπλωματική εργασία", "Μεταπτυχιακή εργασία", "Τύπος Εργασίας--Διδακτορικές διατριβές", "Διπλωματική εργασία (EL)", "Πτυχιακή Εργασία", "ΠΤΥΧΙΑΚΗ ΕΡΓΑΣΙΑ (EL)", "Διδακτορική εργασία", "Μεταπτυχιακές εργασίες", "Μεταπτυχιακή Εργασία (EL)", "Πτυχιακή εργασία (EL)", "πτυχιακή / διπλωματική εργασία", "μεταπτυχιακή εργασία", "Διπλωματική εργασία Μεταπτυχιακή εργασία (EL)", "Πτυχιακή διπλωματική εργασία", "Τύπος Εργασίας--Προγράμματα Σπουδών", "Διπλωματική εργασία (EL)", "Τύπος Εργασίας--Διάφορα", "Μεταπτυχικές εργασίες", "Τύπος Εργασίας--Μελέτες", "Τύπος Εργασίας--Πρακτικά Συνεδρίων", "Εργασία", "μεταπτυχιακή / διπλωματική εργασία", "Πτυχιακή / διπλωματική εργασία", "Κείμενο εργασίας", "Διπλωματικές εργασίες (EL)", "μεταπτυχιακές εργασίες", "Σχολή/Τμήμα--Ιατρική Σχολή--Τμήμα Ιατρικής--Μεταπτυχιακές εργασίες ειδίκευσης", "Σχολή/Τμήμα--Σχολή Θετικών και Τεχνολογικών Επιστημών--Τμήμα Βιολογίας--Μεταπτυχιακές εργασίες ειδίκευσης", "Διπλωματική εργασία Πτυχιακή εργασία (EL)", "Μεταπτυχιακή / διπλωματική εργασία", "Κείμενο εργασίας (EL)", "ΔΙπλωματική εργασία (EL)", "Διπλωματιή εργασία (EL)", "Διπλωματική εργασία (EN)", "Διπλωματική εργασιά (EL)", "Μεταπτυχιακή Διπλωματική Εργασία", "Μεταπτυχικές Εργασίες", "Πτυχιακή / Διπλωματική εργασία", "Συνάντηση εργασίας (EL)", "Διπλμωματική εργασία (EL)", "Διπλωματική εργασία Διδακτορική διατριβή (EL)", "Μεταπτυχιακές Εργασίε", "Μεταπυχιακές Εργασίες", "Μετατπυχιακές Εργασίες", "Βιβλιογραφία: σ. Διπλωματική εργασία - Πάντει", "Διιπλωματική εργασία (EL)", "Διπλωματική έργασία (EL)", "Διπλωματική εργασίά (EL)", "Διπλωματική εργασίας (EL)", "Δπλωματική εργασία (EL)", "Εργασία (EN)", "Μεταοτυχιακές εργασίες", "Μεταπττυχιακές Εργασίες", "Μεταπτυχαικές Εργασίες", "Μεταπτυχιακέ Εργασίες", "Μεταπτυχιακές ΕΕργασίες", "Μεταπτυχιακές Εργασίας", "Μεταπτυχιακές Εργασίεςc", "Μεταπτυχιακές Εργασιες", "Μεταπτυχιακέςς Εργασίες", "Μεταπτυχιακή Διπλωματική Εργασία", "Μεταπτυχιακή διπλωματική εργασία", "Μεταπτυχιακή διπλωματική Εργασία", "Μεταπτυχιακή εργασία (EL)", "Μετπαπτυχιακές Εργασίες", "Μετπατυχιακές Εργασίες", "Μταπτυχιακές Εργασίες", "πτυχιακή διπλωματική εργασία"]
thesis -> thesis : ["bachelorThesis", "PhD Thesis", "masterThesis", "born_digital_postgraduate_thesis", "info:eu-repo/semantics/masterThesis", "info:eu-repo/semantics/bachelorThesis", "Electronic Thesis or Dissertation (EN)", "masterThesis (EN)", "bachelorThesis (EN)", "Master Thesis (EL)", "MSc thesis", "PhD Thesis / Διδακτορική Διατριβή", "Thesis (EL)", "doctoralThesis", "born_digital_thesis", "Master Thesis", "born_digital_graduate_thesis", "Thesis (EN)", "graduate_thesis", "Thesis", "postgraduate_thesis", "doctoralThesis (EN)", "BSc thesis", "masterThesis (EL)", "Thesis (Masters)", "Bcs thesis", "Doctoral Thesis (EL)", "thesis", "MSc Thesis", "Electronic Thesis or Dissertation (EL)", "info:eu-repo/semantics/doctoralThesis", "Doctoral Thesis", "bachelorThesis (EL)", "master thesis", "MSc thesis", "Phd thesis", "doctoralThesis (EL)", "MasterThesis (EN)", "Bachelorthesis (EN)", "PhD thesis", "MasterThesis", "BachelorThesis (EN)", "Msc thesis", "mastherThesis (EN)", "DiplomaThesis", "Electronic Thesis or Dissertation", "dissartation thesis", "BCs thesis", "BSC thesis", "Bachelorthesis", "Bsc thesis", "Diploma Thesis (EL)", "MDc thesis", "MSC thesis", "Master Thesis (EN)", "Master's thesis", "nfo:eu-repo/semantics/doctoralThesis", "Βachelorthesis (EN)", "ΜSc thesis"]
εγγραφ -> έγγραφο : ["Διοικητικά έγγραφα", "Νοταριακά έγγραφα", "Ιδιωτικά δικαιοπρακτικά έγγραφα", "Νομικά έγγραφα", "Διοικητικό έγγραφο (EL)", "Δικαστικά έγγραφα", "Ιδιωτικό δικαιοπρακτικό έγγραφο", "Δημόσια έγγραφα", "Ιδιωτικά έγγραφα", "Δημόσια έγγραφα/Δικαστικές αποφάσεις", "Διοικητικά έγγραφαφ", "Διοικητικό έγγραφο", "Νοταριακά έγγραφα/Δικαστικές αποφάσεις", "Έγγραφα τοπικής αρχής", "Δημόσια έγγραφα τοπικών αρχών", "Δημόσιο έγγραφο τοπικής αρχής", "Δικαιοπρακτικά έγγραφα", "Διοικητικά έγγραφα/Δικαστικές αποφάσεις", "Διπλωματικά έγγραφα", "Ιδιωτικό έγγραφο", "Νοταριακό έγγραφο", "Προξενικά έγγραφα", "Δημόσια έγγραφα (τοπικής αρχής)", "Δημόσια έγγραφα τοπικής αρχής", "Δικαστικές αποφάσεις και δικαστικά έγγραφα", "Δικαστικές αποφάσεις/Δικαστικά έγγραφα", "Δικαστικό έγγραφο", "Δικοικητικά έγγραφα", "Διοικητιά έγγραφα", "Διοικητικά έγγραφα/Δικαστικά έγγραφα", "Διοικητικά έγγράφα", "Διοικητικά εγγράφα", "Δοιηκητικά έγγραφα", "Εκκλησιαστικό έγγραφο", "Ιδιωτικά έγγραφα και δικαστικές αποφάσεις", "Ιδιωτικά δικαιοπρακτικἀ έγγραφα", "Ιδιωτικά δικαιοπρκατικά έγγραφα", "Νομικά έγγραφα της «Κομπανίας»", "Νοταριακά και ιδιωτικά δικαιοπρακτικά έγγραφα", "Νοταριακό έγγραφο και δικαστική απόφαση"]
αρθρο -> άρθρο : ["Article / Άρθρο", "άρθρο", "Άρθρο σε επιστημονικό περιοδικό", "Άρθρο", "άρθρο περιοδικού", "Άρθρο σε περιοδικό τύπο", "Άρθρο σε επιστημονικό περιοδικό (EL)", "Άρθρο περιοδικού", "Άρθρο Επιστημονικό άρθρο (EL)", "Άρθρο σε επιστημονικό συνέδριο (EL)", "Άρθρο συνεδρίου", "άρθρο τεύχους περιοδικού", "αρθρο", "άρθρο τεύχος περιοδικού", "Άρθρο (EL)", "Άρθρο σε περιοδικό (EL)", "Άρθρο τεύχους περιοδικού", "Άρθρο (Conference paper)", "Άρθρο Περιοδικού", "Άρθρο Τεύχους", "Άρθρο σε συνέδριο (EL)", "Άρθρο τεύχος περιοδικού", "Άρθρο.", "Ερευνητικό άρθρο (EL)", "άρθρο, πρακτικά συνεδρίου", "αρθρό", "άρθο"]
συνεδρ -> συνέδριο : ["Conference / Συνέδριο", "Κεφάλαιο σε πρακτικά συνεδρίου", "Ανακοίνωση σε συνέδριο", "Περίληψη σε συνέδριο", "Πρακτικά συνεδρίου", "Συνέδριο (EL)", "Ανακοίνωση σε συνέδριο (EL)", "Κεφάλαιο σε πρακτικά συνεδρίου (EL)", "Πρακτικά συνεδρίων (EL)", "Συζητήσεις (συνεδριάσεων) (EL)", "Περίληψη σε συνέδριο (EL)", "Αντικείμενο συνεδρίου (EL)", "Άρθρα Συνεδρίων", "Εισήγηση συνεδρίου (EL)", "Εξώφυλλο Συνεδρίου", "Περιεχόμενα συνεδρίου", "Συνέδριο, Πρακτικά", "πρακτικά συνεδρίου"]
περιεχ -> περιεχόμενα : ["περιέχει παραρτήματα (EL)", "περιέχει παραδείγματα (EL)", "περιέχει υποδείγματα (EL)", "Περιεχόμενα Περιοδικού", "Περιεχόμενα Τόμου", "Περιεχόμενα Αφιερώματος", "εξώφυλλο και περιεχόμενα περιοδικού", "Εξώφυλλο και περιεχόμενα περιοδικού", "Εξώφυλλο και περιεχόμενα τεύχους περιοδικού", "Περιεχόμενα Τεύχους", "Περιεχόμενα αφιερώματος", "Περιεχόμενα τεύχους", "εξώφυλλα και περιεχόμενα τευχών περιοδικού", "περιέχει ισολογισμούς (EL)", "περιέχει παράρτημα και ισολογισμούς (EL)", "περιεχόμενα περιοδικού"]
en -> EN : ["7 (EN)", "102 (EN)", "1 (EN)", "101 (EN)", "109 (EN)", "108 (EN)", "999 (EN)", "104 (EN)", "110 (EN)", "112 (EN)", "106 (EN)", "203 (EN)", "103 (EN)", "105 (EN)", "107 (EN)", "204 (EN)"]
διατρι -> διατριβή : ["Διδακτορικές Διατριβές", "Μεταπτυχιακή Διατριβή", "Διδακτορική διατριβή", "Διδακτορικές διατριβές", "Διδακτορική Διατριβή / Γεωργικό Πανεπιστήμιο Αθηνών", "Διατριβή επί Διδακτορία / Ανωτάτη Γεωπονική Σχολή Αθηνών", "Διατριβή επί Υφηγεσία / Ανωτάτη Γεωπονική Σχολή Αθηνών", "Διδακτορική Διατριβή", "Διδακτορική Διατριβή / Ανωτάτη Γεωπονική Σχολή Αθηνών", "Διπλωματική Διατριβή", "Διατριβή επί Διδακτορία / Εθνικό Καποδιστριακό Πανεπιστήμιο Αθηνών", "Μεταπτυχιακή διατριβή", "Διατριβή επί Διδακτορία / Αριστοτέλειο Πανεπιστήμιο Αθηνών", "Διατριβή επί Διδακτορία / Αριστοτέλειο Πανεπιστήμιο Θεσσαλονίκης", "Διατριβή επί Υφηγεσία / Αριστοτέλειο Πανεπιστήμιο Αθηνών"]
paper -> paper : ["full paper", "Working Paper (EL)", "Bachelor's Degree Paper (EN)", "short paper", "Journal (paper) (EL)", "Conference (paper) (EN)", "Conference (paper) (EL)", "Working Paper (EN)", "Journal (paper) (EN)", "Working Paper", "Bachelor's Degree Paper (EL)", "full paper (EL)", "conference paper", "Bachelor's Degree Paper", "Working paper"]
βιβλιο -> βιβλίο : ["Βιβλίο (EL)", "Βιβλίο", "Κεφάλαιο βιβλίου", "Βιβλιοκρισία", "βιβλίο", "Βιβλιογραφία", "Βιβλίο (EL)", "Βιβλίο-Μονογραφία (EL)", "Βιβλιο", "Βιβλιογραφία: σ. 50-52", "Βιβλιοκρίσια", "Ηλεκτρονικό βιβλίο", "Μέρος βιβλίου (EL)", "εξώφυλλο βιβλίου"]
book -> book : ["info:eu-repo/semantics/book", "Book (EN)", "book", "Book", "book (EN)", "Book (EL)", "book review", "Book Chapter/Part of Publication (EL)", "Book chapter", "Book chapter (EN)", "Book reviews (EL)", "e-book", "Book Chapter/Part of Publication (EN)", "book part"]
rticle -> article : ["scientific_publication_article", "journalArticle (EN)", "info:eu-repo/semantics/article", "article", "journalArticle", "Article (EN)", "Article", "journal article", "Article (EL)", "Αcrticle (EL)"]
el -> EL : ["7 (EL)", "1 (EL)", "2 (EL)", "4 (EL)", "203 (EL)", "6 (EL)", "106 (EL)", "5 (EL)", "207 (EL)", "204 (EL)"]
εριοδι -> περιοδικό : ["Τεύχος περιοδικού (EL)", "τεύχος περιοδικού", "Περιοδικό (EL)", "Περιοδική έκδοση", "Τεύχος Περιοδικού", "Περιοδικό", "Τεύχος περιοδικού", "Εξώφυλλο τεύχους περιοδικού", "Ευρετήριο περιοδικού"]
image -> image : ["image (EN)", "Moving Image (EN)", "Image (EL)", "Image", "Moving Image", "Image (EN)", "Still Image", "still image", "Image, 3-D"]
ηχος -> ήχος : ["Ήχος Β', Δι (EL)", "Ήχος Β', Δι (EL)", "Ήχος Β', Δι", "Ήχος Πλάγιος Α', Πα", "Ήχος Πλάγιος Α', Πα (EL)", "Ήχος Πλάγιος Α', Πα, αδζέμ (EL)", "Ήχος Πλάγιος Β' Πα = Plagal 2nd, Pa. (EL)", "Ήχος Πλάγιος Β', Πα (EL)", "Ήχος Πλάγιος Δ', Νη (EL)"]
εκδηλω -> εκδήλωση : ["Εκδήλωση", "Εκπαιδευτική εκδήλωση (EL)", "Εκδηλώσεις ΕΚΤ (EL)", "Εκδηλώσεις άλλων φορέων (EL)", "Επετειακή εκδήλωση (EL)", "Εορταστική εκδήλωση (EL)", "Εκδήλωση (EL)", "Πολιτιστική εκδήλωση (EL)"]
ημειωσ -> σημειώσεις : ["Σημειώσεις Μαθημάτων", "Διδακτικές σημειώσεις Θεωρίας", "Σημειώσεις", "Φάκελος σημειώσεων", "Διδακτικές σημειώσεις Εργαστηρίου", "Σημειώσεις μαθημάτων", "Φάκελος Σημειώσεων", "Σημειώσεις μαθήματος"]
τυχιακ -> μεταπτυχιακή/πτυχιακή : ["Μεταπτυχιακές Εραγσίες", "Μεταπτυχιακές Eργασίες", "Μεταπτυχιακές Ερεγασίες", "Μεταπτυχιακές Ερτγασίες", "Μεταπτυχιακκές Εργαασίες", "Μεταπτυχιακό", "Πτυχιακή διπλωματική ιστορία"]
αποφασ -> δικαστική απόφαση : ["Δικαστικές αποφάσεις", "Απόφαση σωματείου", "Απόφαση τοπικής αρχής", "Δικαστικές αποφάσεις επιτρόπων", "Δικαστικές αποφἀσεις", "Δικαστική απόφαση", "Δικαστική απόφαση επιτρόπων"]
erence -> συνέδριο/αναφορά : ["conferenceItem (EN)", "conferenceObject", "conferenceItem", "Conference Poster", "ConferenceItem", "Conference Catalogue", "Reference Document (EN)"]
νοταρι -> νοταριακό : ["Νοταριακές πράξεις", "Νοταριακή πράξη", "Νοταριακές πηγές", "Νοταριάκες πράξεις", "Νοταριακά έγγρφα", "Κατάλογοι νοταριακών αρχείων", "Νοταριακές"]
cation -> επιστημονική δημοσίευση : ["scientific_publication_inproceedings", "scientific_publication_book", "scientific_publication_book_chapter", "scientific_publication_inproceedings_short", "scientific_publication", "scientific_publication_poster", "Application"]
cordin -> recording : ["Recording, oral (EL)", "Recording, musical (EN)", "Recording, oral (EN)", "Recording, acoustical (EL)", "Recording, acoustical (EN)", "Recording, musical (EL)", "Recording, oral"]
πλωματ -> διπλωματική : ["Διπλωματική εξέταση (EL)", "Διπλωματική Εξέταση (EL)", "Διπλωματική εργσαία (EL)", "Διπλωματικη εξέταση (EL)", "Διπλωματκή εξέταση (EL)", "Δπλωματική εξέταση (EL)"]
ataset -> dataset : ["dataset", "Dataset", "research_data_set", "Dataset (EN)", "Trainings Dataset", "Dataset (EL)"]
design -> design : ["Art and design books", "Graphic Design", "Product design", "Object design", "Visual Design", "Web design"]
report -> Report : ["report", "Technical Report (EL)", "report (EN)", "Technical Report (EN)", "Technical Report", "Report"]
τηριδα -> επετηρίδα : ["Επετηρίδα", "Επτηρίδα", "Επέτηρίδα", "Επετηριδα", "Επιτηρίδα", "επετηρίδα"]
ογραφι -> μονογραφία : ["Μονογραφία", "Φωτογραφία (EL)", "Συμβολαιογραφική πράξη", "Κεφάλαιο μονογραφίας", "Συμβολαιογραφικές πράξεις"]
κειμεν -> κείμενο : ["Νομοθετικά κείμενα", "Νομικά κείμενα", "Νομοθετικό κείμενο", "Διοικητικά κείμενα", "Κείμενο (EL)"]
eprint -> preprint : ["preprint", "Preprint", "Preprint (EL)", "Reprint (EN)", "Plan or blueprint (EN)"]
other -> other : ["other (EN)", "other", "Other", "Other (EL)", "Other (EN)"]
εκθεση -> έκθεση : ["Στατιστική έκθεση (EL)", "Έκθεση/Αναφορά", "Έκθεση δραστηριοτήτων (Ετήσια έκθεση) (EL)", "Τεχνική έκθεση (EL)", "Έκθεση πολιτικής (στρατηγική) (EL)"]
τευχος -> τεύχος : ["άρθρα, τεύχος", "τεύχος", "Τεύχος", "Τεύχος άρθρου", "εύχος"]
journa -> journal : ["journal_paper", "journal_issue", "journal_volume", "journal"]
tation -> dissertation : ["Bachelor Dissertation (EL)", "Bachelor Dissertation", "Presentation (EN)", "Presentation"]
musica -> musical : ["Musical Score (EN)", "Musical Score (EL)", "Musical Score (EL)", "Score (musical) (EN)"]
arning -> learning : ["learningMaterial", "Learning Object", "Learning Object (EL)", "Learning Object (EN)"]
bition -> exhibition : ["Exhibitions", "Exhibition catalogue", "Exhibition and event catalogue", "Exhibition author"]
ection -> συλλογή/εκλογές : ["elections_volume_part", "collection", "elections_volume", "Collection"]
text -> text : ["Text", "text", "Text (EL)", "Text (EN)"]
video -> video : ["Video", "Video (EL)", "video", "Video (EN)"]
antics -> μεταδεδομένα/metadata : ["info:eu-repo/semantics/lecture", "info:eu-repo/semantics/bach", "info:eu-repo/semantics/openAccess"]
λαγιος -> πλάγιος : ["Πλάγιος Δ', Νη (EL)", "Πλάγιος Α', Πα (EL)", "Πλάγιος Β', Πα = Plagal 2nd, Pa. (EL)"]
εφαλαι -> κεφάλαιο : ["Τμήμα έκδοσης Κεφάλαιο (EL)", "Κεφάλαιο σε συλλογικό τόμο (EL)", "Κεφάλαιο σε σειρά"]
poster -> poster : ["Posters (EN)", "poster (EL)", "Posters (EL)"]
αραρτη -> παράρτημα : ["41, Παράρτημα 9", "παράρτημα ισολογισμών (EL)", "παράρτημα πινάκων (EL)"]
ateria -> material : ["Old digitized material (EL)", "Instructional Material/Guideline (EN)", "Material Analysis (DE)"]
ετηριο -> ευρετήριο : ["Ευρετήριο", "Ευρετήριο άρθρων", "Ευρετήριο Άρθρων"]
letter -> letter : ["Newsletter (EN)", "Newsletter", "Letter (EL)"]
αδικτυ -> διαδικτυακό : ["Διαδικτυακή ημερίδα (EL)", "Διαδικτυακό σεμινάριο (EL)", "Διαδικτυακή εφαρμογή (EL)"]
εικονα -> εικόνα : ["εικόνα", "Ψηφιακή εικόνα", "εικονα"]
μελετη -> μελέτη : ["Μελέτη (EL)", "Μελέτη (EL)", "Μελέτη"]
οδηγος -> οδηγός : ["Εγχειρίδιο/Οδηγός (EL)", "Εγχειρίδιο/Οδηγός", "Οδηγός σπουδών (EL)"]
υλικο -> υλικό : ["Εκπαιδευτικό υλικό", "Παράγωγο υλικό (Ασκήσεις)", "Χειρόγραφο υλικό"]
διδακτ -> διδακτορική : ["Μεταδιδακτορική έρευνα", "Διδακτορικές Διτριβές"]
πρακτι -> πρακτικά : ["Ιδιωτικά δικαιοπρακτικά", "Πρακτικά Συγκλήτου"]
επιστη -> πανεπιστημιακό : ["Πανεπιστημιακές παραδόσεις (EL)", "Πάντειο Πανεπιστήμιο, Τμήμα Δημόσιας Διοίκησης"]
ctoral -> doctoral : ["doctoral", "Postdoctoral Reseach"]
chapte -> chapter : ["bookChapter (EN)", "bookChapter"]
πραξει -> πράξεις : ["Πατριαρχικές πράξεις", "Νοταρακές πράξεις"]
ακοινω -> ανακοίνωση : ["Αναρτημένη ανακοίνωση", "Αναρτημένη ανακοίνωση (EL)"]
ecture -> lecture : ["Lecture", "Διάλεξη (Lecture)"]
γραμμα -> πρόγραμμα : ["Ερευνητικό πρόγραμμα (EL)", "Πατριαρχικό Γράμμα"]
animat -> animation : ["Animation", "animation"]
archiv -> archive : ["archival_book", "archive"]
ftware -> software : ["Software", "Software (EL)"]
mp -> media/πολυμέσα : ["Mp3 (EN)", "Mp4 (EN)"]
papers -> papers : ["Research papers (EL)", "Working papers"]
series -> series : ["subseries", "series"]
tape -> tape : ["tape", "tape (EL)"]
torial -> editorial : ["Editorial", "tutorial"]
αλλο -> άλλο : ["Άλλο (EL)", "Άλλο"]
ανατυπ -> ανάτυπο : ["Ανάτυπο", "Ανάτυπον (EL)"]
αρουσι -> παρουσίαση : ["Οπτική παρουσίαση", "Παρουσίαση (EL)"]
δελτιο -> δελτίο : ["Ενημερωτικό δελτίο (EL)", "Ενημερωτικό δελτίο/Δελτίο"]
επιστο -> επιστολή : ["Επιστολές", "Ιδιωτική επιστολή"]
ιμαντε -> ντοκιμαντέρ : ["Ντοκιμαντέρ (EL)", "Ντοκιμαντέρ"]
λλαδιο -> φυλλάδιο : ["Φυλλάδιο", "Φυλλάδιο (EL)"]
δικαστ -> δικαστικό : ["Δικαστικές διαφορές"]
achelo -> bachelor : ["Bachelor's Degree Project (EN)"]
master -> masterThesis : ["masterΤhesis"]
εξωφυλ -> εξώφυλλο : ["εξώφυλλο"]
msc -> msc : ["MSc"]
επετηρ -> επετηρίδες : ["Επετηρίδες"]
digita -> digital : ["Digital artifact"]
review -> review : ["PeerReviewed"]
αρθρα -> άρθρα : ["άρθρα"]
αρθρων -> άρθρων : ["Συλλογή άρθρων"]
αστηρι -> εργαστήριο : ["Εργαστήριο (EL)"]
ερευνη -> έρευνα : ["Ερευνητικά δεδομένα"]
access -> access : ["accessible_textbook"]
event -> event : ["Event"]
graphi -> bibliographic : ["Bibliographical bulletin"]
αταλογ -> κατάλογος : ["Κατάλογος"]
διαλεξ -> διάλεξη : ["Διάλεξη"]
εισηγη -> εισήγηση : ["εισήγηση"]
εμιναρ -> σεμινάριο : ["Σεμινάριο (EL)"]
ζητησε -> συζητήσεις : ["Συζητήσεις στρογγυλής τραπέζης (EL)"]
ημεριδ -> ημερίδα : ["Ημερίδα (EL)"]
aching -> teaching : ["Teaching resource"]
album -> album : ["Music Album"]
aldata -> spatial_data : ["geospatial_data"]
allati -> installation : ["Installations"]
assete -> cassette : ["cassete"]
bookpa -> bookpart : ["bookPart"]
creeni -> screening : ["Screening"]
curati -> curating : ["Curating"]
curric -> curriculum : ["Curriculum guide (EL)"]
dat -> dat : ["dat"]
data -> data : ["Data"]
erform -> performance : ["Performance"]
erimen -> experiment : ["Experiment (EN)"]
film -> film : ["Film"]
folder -> folder : ["folder"]
map -> map : ["map"]
patent -> patent : ["patent"]
printe -> printed : ["Printed"]
rape -> rape : ["rape"]
sound -> sound : ["Sound"]
αγραφε -> προδιαγραφές : ["Προδιαγραφές (EL)"]
αλλιερ -> καλλιέργεια : ["Σύμβαση καλλιέργειας"]
αναστα -> Ψειρίδου, Αναστασία : ["Ψειρίδου, Αναστασία"]
ανειες -> διαφάνειες : ["Διαφάνειες"]
ανηγυρ -> πανηγυρικός : ["Πανηγυρικός Λόγος (EL)"]
ανονικ -> κανονικό : ["Νομοκανονικές διατάξεις"]
αρθο -> άρθρο : ["άρθο"]
αρτιου -> Πώληση χωραφιού κατόπιν εκτιμήσεως, 1751, Μαρτίου 24 : ["Πώληση χωραφιού κατόπιν εκτιμήσεως, 1751, Μαρτίου 24"]
βιντεο -> βίντεο : ["Προωθητικά βίντεο (EL)"]
βουλλο -> χρυσόβουλλο : ["Χρυσόβουλλο"]
γραφησ -> ηχογράφηση : ["Ηχογράφηση (EL)"]
γχομεν -> ελεγχόμενο : ["Ελεγχόμενο λεξιλόγιο (EL)"]
ελισσα -> μέλισσα : ["Μέλισσα (EL)"]
εντευξ -> συνέντευξη : ["Συνέντευξη (EL)"]
ερολογ -> ημερολόγιο : ["Ημερολόγιο"]
εσιτεχ -> ευρεσιτεχνία : ["Ευρεσιτεχνία"]
ευχος -> τεύχος : ["εύχος"]
ηφισμα -> ψήφισμα : ["Ψήφισμα"]
ομιλια -> ομιλία : ["Ομιλία (EL)"]
ομνημα -> υπόμνημα : ["Υπόμνημα"]
χαρτης -> χάρτης : ["Χάρτης (EL)"]
