εργασι : ["Μεταπτυχιακές Εργασίες", "Πτυχιακή εργασία", "Πτυχιακή Εργασία (EL)", "Μεταπτυχιακή διπλωματική εργασία", "Διπλωματική εργασία", "Μεταπτυχιακή εργασία", "Τύπος Εργασίας--Διδακτορικές διατριβές", "Διπλωματική εργασία (EL)", "Πτυχιακή Εργασία", "ΠΤΥΧΙΑΚΗ ΕΡΓΑΣΙΑ (EL)", "Διδακτορική εργασία", "Μεταπτυχιακές εργασίες", "Μεταπτυχιακή Εργασία (EL)", "Πτυχιακή εργασία (EL)", "πτυχιακή / διπλωματική εργασία", "μεταπτυχιακή εργασία", "Διπλωματική εργασία Μεταπτυχιακή εργασία (EL)", "Πτυχιακή διπλωματική εργασία", "Τύπος Εργασίας--Προγράμματα Σπουδών", "Διπλωματική εργασία (EL)", "Τύπος Εργασίας--Διάφορα", "Μεταπτυχικές εργασίες", "Τύπος Εργασίας--Μελέτες", "Τύπος Εργασίας--Πρακτικά Συνεδρίων", "Εργασία", "μεταπτυχιακή / διπλωματική εργασία", "Πτυχιακή / διπλωματική εργασία", "Κείμενο εργασίας", "Διπλωματικές εργασίες (EL)", "μεταπτυχιακές εργασίες", "Σχολή/Τμήμα--Ιατρική Σχολή--Τμήμα Ιατρικής--Μεταπτυχιακές εργασίες ειδίκευσης", "Σχολή/Τμήμα--Σχολή Θετικών και Τεχνολογικών Επιστημών--Τμήμα Βιολογίας--Μεταπτυχιακές εργασίες ειδίκευσης", "Διπλωματική εργασία Πτυχιακή εργασία (EL)", "Μεταπτυχιακή / διπλωματική εργασία", "Κείμενο εργασίας (EL)", "ΔΙπλωματική εργασία (EL)", "Διπλωματιή εργασία (EL)", "Διπλωματική εργασία (EN)", "Διπλωματική εργασιά (EL)", "Μεταπτυχιακή Διπλωματική Εργασία", "Μεταπτυχικές Εργασίες", "Πτυχιακή / Διπλωματική εργασία", "Συνάντηση εργασίας (EL)", "Διπλμωματική εργασία (EL)", "Διπλωματική εργασία Διδακτορική διατριβή (EL)", "Μεταπτυχιακές Εργασίε", "Μεταπυχιακές Εργασίες", "Μετατπυχιακές Εργασίες", "Βιβλιογραφία: σ. Διπλωματική εργασία - Πάντει", "Διιπλωματική εργασία (EL)", "Διπλωματική έργασία (EL)", "Διπλωματική εργασίά (EL)", "Διπλωματική εργασίας (EL)", "Δπλωματική εργασία (EL)", "Εργασία (EN)", "Μεταοτυχιακές εργασίες", "Μεταπττυχιακές Εργασίες", "Μεταπτυχαικές Εργασίες", "Μεταπτυχιακέ Εργασίες", "Μεταπτυχιακές ΕΕργασίες", "Μεταπτυχιακές Εργασίας", "Μεταπτυχιακές Εργασίεςc", "Μεταπτυχιακές Εργασιες", "Μεταπτυχιακέςς Εργασίες", "Μεταπτυχιακή Διπλωματική Εργασία", "Μεταπτυχιακή διπλωματική εργασία", "Μεταπτυχιακή διπλωματική Εργασία", "Μεταπτυχιακή εργασία (EL)", "Μετπαπτυχιακές Εργασίες", "Μετπατυχιακές Εργασίες", "Μταπτυχιακές Εργασίες", "πτυχιακή διπλωματική εργασία"]
thesis : ["bachelorThesis", "PhD Thesis", "masterThesis", "born_digital_postgraduate_thesis", "info:eu-repo/semantics/masterThesis", "info:eu-repo/semantics/bachelorThesis", "Electronic Thesis or Dissertation (EN)", "masterThesis (EN)", "bachelorThesis (EN)", "Master Thesis (EL)", "MSc thesis", "PhD Thesis / Διδακτορική Διατριβή", "Thesis (EL)", "doctoralThesis", "born_digital_thesis", "Master Thesis", "born_digital_graduate_thesis", "Thesis (EN)", "graduate_thesis", "Thesis", "postgraduate_thesis", "doctoralThesis (EN)", "BSc thesis", "masterThesis (EL)", "Thesis (Masters)", "Bcs thesis", "Doctoral Thesis (EL)", "thesis", "MSc Thesis", "Electronic Thesis or Dissertation (EL)", "info:eu-repo/semantics/doctoralThesis", "Doctoral Thesis", "bachelorThesis (EL)", "master thesis", "MSc thesis", "Phd thesis", "doctoralThesis (EL)", "MasterThesis (EN)", "Bachelorthesis (EN)", "PhD thesis", "MasterThesis", "BachelorThesis (EN)", "Msc thesis", "mastherThesis (EN)", "DiplomaThesis", "Electronic Thesis or Dissertation", "dissartation thesis", "BCs thesis", "BSC thesis", "Bachelorthesis", "Bsc thesis", "Diploma Thesis (EL)", "MDc thesis", "MSC thesis", "Master Thesis (EN)", "Master's thesis", "nfo:eu-repo/semantics/doctoralThesis", "Βachelorthesis (EN)", "ΜSc thesis"]
εγγραφ : ["Διοικητικά έγγραφα", "Νοταριακά έγγραφα", "Ιδιωτικά δικαιοπρακτικά έγγραφα", "Νομικά έγγραφα", "Διοικητικό έγγραφο (EL)", "Δικαστικά έγγραφα", "Ιδιωτικό δικαιοπρακτικό έγγραφο", "Δημόσια έγγραφα", "Ιδιωτικά έγγραφα", "Δημόσια έγγραφα/Δικαστικές αποφάσεις", "Διοικητικά έγγραφαφ", "Διοικητικό έγγραφο", "Νοταριακά έγγραφα/Δικαστικές αποφάσεις", "Έγγραφα τοπικής αρχής", "Δημόσια έγγραφα τοπικών αρχών", "Δημόσιο έγγραφο τοπικής αρχής", "Δικαιοπρακτικά έγγραφα", "Διοικητικά έγγραφα/Δικαστικές αποφάσεις", "Διπλωματικά έγγραφα", "Ιδιωτικό έγγραφο", "Νοταριακό έγγραφο", "Προξενικά έγγραφα", "Δημόσια έγγραφα (τοπικής αρχής)", "Δημόσια έγγραφα τοπικής αρχής", "Δικαστικές αποφάσεις και δικαστικά έγγραφα", "Δικαστικές αποφάσεις/Δικαστικά έγγραφα", "Δικαστικό έγγραφο", "Δικοικητικά έγγραφα", "Διοικητιά έγγραφα", "Διοικητικά έγγραφα/Δικαστικά έγγραφα", "Διοικητικά έγγράφα", "Διοικητικά εγγράφα", "Δοιηκητικά έγγραφα", "Εκκλησιαστικό έγγραφο", "Ιδιωτικά έγγραφα και δικαστικές αποφάσεις", "Ιδιωτικά δικαιοπρακτικἀ έγγραφα", "Ιδιωτικά δικαιοπρκατικά έγγραφα", "Νομικά έγγραφα της «Κομπανίας»", "Νοταριακά και ιδιωτικά δικαιοπρακτικά έγγραφα", "Νοταριακό έγγραφο και δικαστική απόφαση"]
αρθρο : ["Article / Άρθρο", "άρθρο", "Άρθρο σε επιστημονικό περιοδικό", "Άρθρο", "άρθρο περιοδικού", "Άρθρο σε περιοδικό τύπο", "Άρθρο σε επιστημονικό περιοδικό (EL)", "Άρθρο περιοδικού", "Άρθρο Επιστημονικό άρθρο (EL)", "Άρθρο σε επιστημονικό συνέδριο (EL)", "Άρθρο συνεδρίου", "άρθρο τεύχους περιοδικού", "αρθρο", "άρθρο τεύχος περιοδικού", "Άρθρο (EL)", "Άρθρο σε περιοδικό (EL)", "Άρθρο τεύχους περιοδικού", "Άρθρο (Conference paper)", "Άρθρο Περιοδικού", "Άρθρο Τεύχους", "Άρθρο σε συνέδριο (EL)", "Άρθρο τεύχος περιοδικού", "Άρθρο.", "Ερευνητικό άρθρο (EL)", "άρθρο, πρακτικά συνεδρίου", "αρθρό"]
συνεδρ : ["Conference / Συνέδριο", "Κεφάλαιο σε πρακτικά συνεδρίου", "Ανακοίνωση σε συνέδριο", "Περίληψη σε συνέδριο", "Πρακτικά συνεδρίου", "Συνέδριο (EL)", "Ανακοίνωση σε συνέδριο (EL)", "Κεφάλαιο σε πρακτικά συνεδρίου (EL)", "Πρακτικά συνεδρίων (EL)", "Συζητήσεις (συνεδριάσεων) (EL)", "Περίληψη σε συνέδριο (EL)", "Αντικείμενο συνεδρίου (EL)", "Άρθρα Συνεδρίων", "Εισήγηση συνεδρίου (EL)", "Εξώφυλλο Συνεδρίου", "Περιεχόμενα συνεδρίου", "Συνέδριο, Πρακτικά", "πρακτικά συνεδρίου"]
περιεχ : ["περιέχει παραρτήματα (EL)", "περιέχει παραδείγματα (EL)", "περιέχει υποδείγματα (EL)", "Περιεχόμενα Περιοδικού", "Περιεχόμενα Τόμου", "Περιεχόμενα Αφιερώματος", "εξώφυλλο και περιεχόμενα περιοδικού", "Εξώφυλλο και περιεχόμενα περιοδικού", "Εξώφυλλο και περιεχόμενα τεύχους περιοδικού", "Περιεχόμενα Τεύχους", "Περιεχόμενα αφιερώματος", "Περιεχόμενα τεύχους", "εξώφυλλα και περιεχόμενα τευχών περιοδικού", "περιέχει ισολογισμούς (EL)", "περιέχει παράρτημα και ισολογισμούς (EL)", "περιεχόμενα περιοδικού"]
en : ["7 (EN)", "102 (EN)", "1 (EN)", "101 (EN)", "109 (EN)", "108 (EN)", "999 (EN)", "104 (EN)", "110 (EN)", "112 (EN)", "106 (EN)", "203 (EN)", "103 (EN)", "105 (EN)", "107 (EN)", "204 (EN)"]
διατρι : ["Διδακτορικές Διατριβές", "Μεταπτυχιακή Διατριβή", "Διδακτορική διατριβή", "Διδακτορικές διατριβές", "Διδακτορική Διατριβή / Γεωργικό Πανεπιστήμιο Αθηνών", "Διατριβή επί Διδακτορία / Ανωτάτη Γεωπονική Σχολή Αθηνών", "Διατριβή επί Υφηγεσία / Ανωτάτη Γεωπονική Σχολή Αθηνών", "Διδακτορική Διατριβή", "Διδακτορική Διατριβή / Ανωτάτη Γεωπονική Σχολή Αθηνών", "Διπλωματική Διατριβή", "Διατριβή επί Διδακτορία / Εθνικό Καποδιστριακό Πανεπιστήμιο Αθηνών", "Μεταπτυχιακή διατριβή", "Διατριβή επί Διδακτορία / Αριστοτέλειο Πανεπιστήμιο Αθηνών", "Διατριβή επί Διδακτορία / Αριστοτέλειο Πανεπιστήμιο Θεσσαλονίκης", "Διατριβή επί Υφηγεσία / Αριστοτέλειο Πανεπιστήμιο Αθηνών"]
paper : ["full paper", "Working Paper (EL)", "Bachelor's Degree Paper (EN)", "short paper", "Journal (paper) (EL)", "Conference (paper) (EN)", "Conference (paper) (EL)", "Working Paper (EN)", "Journal (paper) (EN)", "Working Paper", "Bachelor's Degree Paper (EL)", "full paper (EL)", "conference paper", "Bachelor's Degree Paper", "Working paper"]
βιβλιο : ["Βιβλίο (EL)", "Βιβλίο", "Κεφάλαιο βιβλίου", "Βιβλιοκρισία", "βιβλίο", "Βιβλιογραφία", "Βιβλίο (EL)", "Βιβλίο-Μονογραφία (EL)", "Βιβλιο", "Βιβλιογραφία: σ. 50-52", "Βιβλιοκρίσια", "Ηλεκτρονικό βιβλίο", "Μέρος βιβλίου (EL)", "εξώφυλλο βιβλίου"]
book : ["info:eu-repo/semantics/book", "Book (EN)", "book", "Book", "book (EN)", "Book (EL)", "book review", "Book Chapter/Part of Publication (EL)", "Book chapter", "Book chapter (EN)", "Book reviews (EL)", "e-book", "Book Chapter/Part of Publication (EN)", "book part"]
rticle : ["scientific_publication_article", "journalArticle (EN)", "info:eu-repo/semantics/article", "article", "journalArticle", "Article (EN)", "Article", "journal article", "Article (EL)", "Αcrticle (EL)"]
el : ["7 (EL)", "1 (EL)", "2 (EL)", "4 (EL)", "203 (EL)", "6 (EL)", "106 (EL)", "5 (EL)", "207 (EL)", "204 (EL)"]
εριοδι : ["Τεύχος περιοδικού (EL)", "τεύχος περιοδικού", "Περιοδικό (EL)", "Περιοδική έκδοση", "Τεύχος Περιοδικού", "Περιοδικό", "Τεύχος περιοδικού", "Εξώφυλλο τεύχους περιοδικού", "Ευρετήριο περιοδικού"]
image : ["image (EN)", "Moving Image (EN)", "Image (EL)", "Image", "Moving Image", "Image (EN)", "Still Image", "still image", "Image, 3-D"]
ηχος : ["Ήχος Β', Δι (EL)", "Ήχος Β', Δι (EL)", "Ήχος Β', Δι", "Ήχος Πλάγιος Α', Πα", "Ήχος Πλάγιος Α', Πα (EL)", "Ήχος Πλάγιος Α', Πα, αδζέμ (EL)", "Ήχος Πλάγιος Β' Πα = Plagal 2nd, Pa. (EL)", "Ήχος Πλάγιος Β', Πα (EL)", "Ήχος Πλάγιος Δ', Νη (EL)"]
εκδηλω : ["Εκδήλωση", "Εκπαιδευτική εκδήλωση (EL)", "Εκδηλώσεις ΕΚΤ (EL)", "Εκδηλώσεις άλλων φορέων (EL)", "Επετειακή εκδήλωση (EL)", "Εορταστική εκδήλωση (EL)", "Εκδήλωση (EL)", "Πολιτιστική εκδήλωση (EL)"]
ημειωσ : ["Σημειώσεις Μαθημάτων", "Διδακτικές σημειώσεις Θεωρίας", "Σημειώσεις", "Φάκελος σημειώσεων", "Διδακτικές σημειώσεις Εργαστηρίου", "Σημειώσεις μαθημάτων", "Φάκελος Σημειώσεων", "Σημειώσεις μαθήματος"]
τυχιακ : ["Μεταπτυχιακές Εραγσίες", "Μεταπτυχιακές Eργασίες", "Μεταπτυχιακές Ερεγασίες", "Μεταπτυχιακές Ερτγασίες", "Μεταπτυχιακκές Εργαασίες", "Μεταπτυχιακό", "Πτυχιακή διπλωματική ιστορία"]
αποφασ : ["Δικαστικές αποφάσεις", "Απόφαση σωματείου", "Απόφαση τοπικής αρχής", "Δικαστικές αποφάσεις επιτρόπων", "Δικαστικές αποφἀσεις", "Δικαστική απόφαση", "Δικαστική απόφαση επιτρόπων"]
erence : ["conferenceItem (EN)", "conferenceObject", "conferenceItem", "Conference Poster", "ConferenceItem", "Conference Catalogue", "Reference Document (EN)"]
νοταρι : ["Νοταριακές πράξεις", "Νοταριακή πράξη", "Νοταριακές πηγές", "Νοταριάκες πράξεις", "Νοταριακά έγγρφα", "Κατάλογοι νοταριακών αρχείων", "Νοταριακές"]
cation : ["scientific_publication_inproceedings", "scientific_publication_book", "scientific_publication_book_chapter", "scientific_publication_inproceedings_short", "scientific_publication", "scientific_publication_poster", "Application"]
cordin : ["Recording, oral (EL)", "Recording, musical (EN)", "Recording, oral (EN)", "Recording, acoustical (EL)", "Recording, acoustical (EN)", "Recording, musical (EL)", "Recording, oral"]
πλωματ : ["Διπλωματική εξέταση (EL)", "Διπλωματική Εξέταση (EL)", "Διπλωματική εργσαία (EL)", "Διπλωματικη εξέταση (EL)", "Διπλωματκή εξέταση (EL)", "Δπλωματική εξέταση (EL)"]
ataset : ["dataset", "Dataset", "research_data_set", "Dataset (EN)", "Trainings Dataset", "Dataset (EL)"]
design : ["Art and design books", "Graphic Design", "Product design", "Object design", "Visual Design", "Web design"]
report : ["report", "Technical Report (EL)", "report (EN)", "Technical Report (EN)", "Technical Report", "Report"]
τηριδα : ["Επετηρίδα", "Επτηρίδα", "Επέτηρίδα", "Επετηριδα", "Επιτηρίδα", "επετηρίδα"]
ογραφι : ["Μονογραφία", "Φωτογραφία (EL)", "Συμβολαιογραφική πράξη", "Κεφάλαιο μονογραφίας", "Συμβολαιογραφικές πράξεις"]
κειμεν : ["Νομοθετικά κείμενα", "Νομικά κείμενα", "Νομοθετικό κείμενο", "Διοικητικά κείμενα", "Κείμενο (EL)"]
eprint : ["preprint", "Preprint", "Preprint (EL)", "Reprint (EN)", "Plan or blueprint (EN)"]
other : ["other (EN)", "other", "Other", "Other (EL)", "Other (EN)"]
εκθεση : ["Στατιστική έκθεση (EL)", "Έκθεση/Αναφορά", "Έκθεση δραστηριοτήτων (Ετήσια έκθεση) (EL)", "Τεχνική έκθεση (EL)", "Έκθεση πολιτικής (στρατηγική) (EL)"]
τευχος : ["άρθρα, τεύχος", "τεύχος", "Τεύχος", "Τεύχος άρθρου"]
journa : ["journal_paper", "journal_issue", "journal_volume", "journal"]
tation : ["Bachelor Dissertation (EL)", "Bachelor Dissertation", "Presentation (EN)", "Presentation"]
musica : ["Musical Score (EN)", "Musical Score (EL)", "Musical Score (EL)", "Score (musical) (EN)"]
arning : ["learningMaterial", "Learning Object", "Learning Object (EL)", "Learning Object (EN)"]
bition : ["Exhibitions", "Exhibition catalogue", "Exhibition and event catalogue", "Exhibition author"]
ection : ["elections_volume_part", "collection", "elections_volume", "Collection"]
text : ["Text", "text", "Text (EL)", "Text (EN)"]
video : ["Video", "Video (EL)", "video", "Video (EN)"]
antics : ["info:eu-repo/semantics/lecture", "info:eu-repo/semantics/bach", "info:eu-repo/semantics/openAccess"]
λαγιος : ["Πλάγιος Δ', Νη (EL)", "Πλάγιος Α', Πα (EL)", "Πλάγιος Β', Πα = Plagal 2nd, Pa. (EL)"]
εφαλαι : ["Τμήμα έκδοσης Κεφάλαιο (EL)", "Κεφάλαιο σε συλλογικό τόμο (EL)", "Κεφάλαιο σε σειρά"]
poster : ["Posters (EN)", "poster (EL)", "Posters (EL)"]
αραρτη : ["41, Παράρτημα 9", "παράρτημα ισολογισμών (EL)", "παράρτημα πινάκων (EL)"]
ateria : ["Old digitized material (EL)", "Instructional Material/Guideline (EN)", "Material Analysis (DE)"]
ετηριο : ["Ευρετήριο", "Ευρετήριο άρθρων", "Ευρετήριο Άρθρων"]
letter : ["Newsletter (EN)", "Newsletter", "Letter (EL)"]
αδικτυ : ["Διαδικτυακή ημερίδα (EL)", "Διαδικτυακό σεμινάριο (EL)", "Διαδικτυακή εφαρμογή (EL)"]
εικονα : ["εικόνα", "Ψηφιακή εικόνα", "εικονα"]
μελετη : ["Μελέτη (EL)", "Μελέτη (EL)", "Μελέτη"]
οδηγος : ["Εγχειρίδιο/Οδηγός (EL)", "Εγχειρίδιο/Οδηγός", "Οδηγός σπουδών (EL)"]
υλικο : ["Εκπαιδευτικό υλικό", "Παράγωγο υλικό (Ασκήσεις)", "Χειρόγραφο υλικό"]
διδακτ : ["Μεταδιδακτορική έρευνα", "Διδακτορικές Διτριβές"]
πρακτι : ["Ιδιωτικά δικαιοπρακτικά", "Πρακτικά Συγκλήτου"]
επιστη : ["Πανεπιστημιακές παραδόσεις (EL)", "Πάντειο Πανεπιστήμιο, Τμήμα Δημόσιας Διοίκησης"]
ctoral : ["doctoral", "Postdoctoral Reseach"]
chapte : ["bookChapter (EN)", "bookChapter"]
πραξει : ["Πατριαρχικές πράξεις", "Νοταρακές πράξεις"]
ακοινω : ["Αναρτημένη ανακοίνωση", "Αναρτημένη ανακοίνωση (EL)"]
ecture : ["Lecture", "Διάλεξη (Lecture)"]
γραμμα : ["Ερευνητικό πρόγραμμα (EL)", "Πατριαρχικό Γράμμα"]
animat : ["Animation", "animation"]
archiv : ["archival_book", "archive"]
ftware : ["Software", "Software (EL)"]
mp : ["Mp3 (EN)", "Mp4 (EN)"]
papers : ["Research papers (EL)", "Working papers"]
series : ["subseries", "series"]
tape : ["tape", "tape (EL)"]
torial : ["Editorial", "tutorial"]
αλλο : ["Άλλο (EL)", "Άλλο"]
ανατυπ : ["Ανάτυπο", "Ανάτυπον (EL)"]
αρουσι : ["Οπτική παρουσίαση", "Παρουσίαση (EL)"]
δελτιο : ["Ενημερωτικό δελτίο (EL)", "Ενημερωτικό δελτίο/Δελτίο"]
επιστο : ["Επιστολές", "Ιδιωτική επιστολή"]
ιμαντε : ["Ντοκιμαντέρ (EL)", "Ντοκιμαντέρ"]
λλαδιο : ["Φυλλάδιο", "Φυλλάδιο (EL)"]
δικαστ : ["Δικαστικές διαφορές"]
achelo : ["Bachelor's Degree Project (EN)"]
master : ["masterΤhesis"]
εξωφυλ : ["εξώφυλλο"]
msc : ["MSc"]
επετηρ : ["Επετηρίδες"]
digita : ["Digital artifact"]
review : ["PeerReviewed"]
αρθρα : ["άρθρα"]
αρθρων : ["Συλλογή άρθρων"]
αστηρι : ["Εργαστήριο (EL)"]
ερευνη : ["Ερευνητικά δεδομένα"]
access : ["accessible_textbook"]
event : ["Event"]
graphi : ["Bibliographical bulletin"]
αταλογ : ["Κατάλογος"]
διαλεξ : ["Διάλεξη"]
εισηγη : ["εισήγηση"]
εμιναρ : ["Σεμινάριο (EL)"]
ζητησε : ["Συζητήσεις στρογγυλής τραπέζης (EL)"]
ημεριδ : ["Ημερίδα (EL)"]
aching : ["Teaching resource"]
album : ["Music Album"]
aldata : ["geospatial_data"]
allati : ["Installations"]
assete : ["cassete"]
bookpa : ["bookPart"]
creeni : ["Screening"]
curati : ["Curating"]
curric : ["Curriculum guide (EL)"]
dat : ["dat"]
data : ["Data"]
erform : ["Performance"]
erimen : ["Experiment (EN)"]
film : ["Film"]
folder : ["folder"]
map : ["map"]
patent : ["patent"]
printe : ["Printed"]
rape : ["rape"]
sound : ["Sound"]
αγραφε : ["Προδιαγραφές (EL)"]
αλλιερ : ["Σύμβαση καλλιέργειας"]
αναστα : ["Ψειρίδου, Αναστασία"]
ανειες : ["Διαφάνειες"]
ανηγυρ : ["Πανηγυρικός Λόγος (EL)"]
ανονικ : ["Νομοκανονικές διατάξεις"]
αρθο : ["άρθο"]
αρτιου : ["Πώληση χωραφιού κατόπιν εκτιμήσεως, 1751, Μαρτίου 24"]
βιντεο : ["Προωθητικά βίντεο (EL)"]
βουλλο : ["Χρυσόβουλλο"]
γραφησ : ["Ηχογράφηση (EL)"]
γχομεν : ["Ελεγχόμενο λεξιλόγιο (EL)"]
ελισσα : ["Μέλισσα (EL)"]
εντευξ : ["Συνέντευξη (EL)"]
ερολογ : ["Ημερολόγιο"]
εσιτεχ : ["Ευρεσιτεχνία"]
ευχος : ["εύχος"]
ηφισμα : ["Ψήφισμα"]
ομιλια : ["Ομιλία (EL)"]
ομνημα : ["Υπόμνημα"]
χαρτης : ["Χάρτης (EL)"]
